NO ./textures/path_to_the_north_texture

SO ./textures/path_to_the_south_texture
WE ./textures/path_to_the_west_texture
EA ./textures/path_to_the_east_texture
SO ./textures/path_to_the_south_texture
F 22,100,0
C 22,100,0


11111111111111 11111111
1000000000110000000000001
1011000001110000000000001
10010000000000000000001
11111111101000001110000000000001
100000000011000001110111111111111
11110111111111011100000010001
11110111111111011101010010001
11000000110101011100000010001
10000000000000001100000010001
10000000000000001101010010001
11000001110101011111011110N0111
11110111 1110101 101111010001
11111111 1111111 111111111111