NO ./textures/forest128.png
SO ./textures/brick_gray128.png
WE ./textures/purplestone.png
EA ./textures/sand_floor128.png


C 0,0,102
F 0,51,25


        1111111111111111111111111
        1000000C00110000000000001
        10110000011100000C0000001
        1001000000000000000000001
111111111011000001110000000000001
1C0000000011000001110111111111111111111111
11110111111111011100000010001
11110111111111011101010010001
11000000110101011100000010001
1000000000C00000110000CC00W01
10000C00000000001101010010001
1100000111010101111101111000111
11110111 1110101 101111010001
11111111 1111111 11111111111
