NO ./textures/forest128.png
SO ./textures/brick_gray128.png
WE ./textures/purplestone.png
EA ./textures/sand_floor128.png


C 0,0,102
F 0,51,25


        1111111111111111111111111
        1000000000110000000C000001
        1011000001110000000000001
        100100000000000C000000C0001
111111111011000001110000000000001
100000000011000001110111111111111111111111
11110111111111011100000010001
11110111111111011101010010001
110000000110101011100000010001
1000000000000000000000C0000001
100000000000C000110101N010001
110C0000111010101111101111000111
11110111 1110101 101111010001
11111111 1111111 11111111111
