NO ./textures/forest128.png
SO ./textures/brick_gray128.png
WE ./textures/purplestone.png
EA ./textures/sand_floor128.png


C 0,0,102
F 0,51,25

11111111111111111111
1111000000C0000000011
110000000000000C00011
11000C000000000000011
110000000000000000011
110000E00000000C0000C11
1100000C000000000000011
110000C00000000000C0011
11111111111111111111111
