NO ./textures/path_to_the_north_texture
SO ./textures/path_to_the_south_texture
WE ./textures/path_to_the_west_texture
EA ./textures/path_to_the_east_texture

C 232,234,246
F 140,158,255


1111111111
1100111111
10N0111111
1001111111
1111111111
1111111111
