NO ./textures/path_to_the_north_texture
SO ./textures/path_to_the_south_texture
WE ./textures/path_to_the_west_texture
EA ./textures/path_to_the_east_texture
F 100,100,0
C 200,200,0



11111
11001
10N01
10011
11111
