NO ./textures/path_to_the_north_texture
SO ./textures/path_to_the_south_texture
WE ./textures/path_to_the_west_texture
EA ./textures/path_to_the_east_texture
F 100,100,0
C 200,200,0


111111111111111111111111111111111111111111111
100000000000000000000000000000000000000000001
100000000000000000000000000000000000000000001
100000000011111111111111000000000000000000001
100000000001100000000001000000000000000000001
100000000111000000N00001000000000000000000001
100000000001000000000111000000000000000000001
100000000001000000000111000000000000000000001
100000000001111111111110000000000000000000001
100000000000000000000000000000000000000000001
111111111111111111111111111111111111111111111