NO ./textures/forest128.png
SO ./textures/brick_gray128.png
WE ./textures/purplestone.png
EA ./textures/sand_floor128.png


C 0,0,102
F 0,51,25

1111111111111111
1100000000000001
1000000000000001
1000000000000001
1000000E0000C00C1
100000C0000000001
1000000C0000000C01
111111111111111
11111111111111111
