NO ./textures/forest128.png
SO ./textures/brick_gray128.png
WE ./textures/purplestone.png
EA ./textures/sand_floor128.png


C 0,0,102
F 0,51,25

11111111111111111111
111100000000000000011
110000000000000000011
110000000000000000011
110000000000000000011
110000000C000000000W11
11000000000000000000011
11000000000000000000011
11111111111111111111111
